10 11
WWWWWWWWWWWWWWWWWWWWWWWWWWWWWWWWWWWWWWWW
W.r..r..w.r...d.w... .r.wr......w..rr..W
W.......w......rwrr. ...w ..d...w....r.W
W                                      W
Wd......w.r....rw.r. .. w..r..d.w..r.r.W
W.......w.r....rw.r. r..w.....r.w... ..W
Wwwwwwwwwwwwwwwwwwww wwwwwwwwwwwwwwwwwwW
W....rr.w..r....w... ..rw....r..w.....rW
W.......w.. ....w... ...w....r. w.....rW
W                                      W
Wr..r...w....r..w..r ...w......dwr.....W
Wr....r.w..r..r.w... . rw.......wr...r.W
W.r.....w...r...w... . rw.......w r..r.W
Wwwwwwwwwwwwwwwwwwww wwwwwwwwwwwwwwwwwwW
Wr.  ...w....r.rw... ...w.rd..r.w......W
W.....r.wr......w..d ...w ..r...w.r.rr.W
W                                      W
Wd.. .r.wr....r.w.r. ..rw.r.r...w......W
W.....r.wr..d...w... r..w..r....w...rr W
W.d... rw..r....w.Xd r..w. .....w...rr W
W.r.... w.. ..r.w.P. ...w....r.rw.... .W
WWWWWWWWWWWWWWWWWWWWWWWWWWWWWWWWWWWWWWWW

